{
  "name": "GMMK Pro",
  "vendorProductId": 839864388,
  "macros": [
    "subrat.shrestha3@gmail.com",
    "{KC_LGUI,KC_SPC}",
    "{+KC_LGUI}{+KC_LSFT}4{-KC_LSFT}{-KC_LGUI}",
    "{+KC_LGUI}{+KC_LALT}j{-KC_LALT}{-KC_LGUI}",
    "",
    "",
    "",
    "",
    "",
    "",
    "",
    "",
    "",
    "",
    "",
    ""
  ],
  "layers": [
    [
      "KC_LSFT",
      "KC_MUTE",
      "KC_NO",
      "KC_LEFT",
      "KC_RCTL",
      "KC_RGHT",
      "KC_LCTL",
      "MACRO(2)",
      "KC_Q",
      "KC_TAB",
      "KC_A",
      "KC_ESC",
      "KC_Z",
      "KC_PGUP",
      "KC_GRV",
      "KC_1",
      "KC_W",
      "KC_CAPS",
      "KC_S",
      "KC_NO",
      "KC_X",
      "KC_PGDN",
      "KC_BRID",
      "KC_2",
      "KC_E",
      "0xc1",
      "KC_D",
      "MACRO(1)",
      "KC_C",
      "KC_UP",
      "KC_BRIU",
      "KC_3",
      "KC_R",
      "KC_T",
      "KC_F",
      "KC_G",
      "KC_V",
      "KC_B",
      "KC_5",
      "KC_4",
      "KC_U",
      "KC_Y",
      "KC_J",
      "KC_H",
      "KC_M",
      "KC_N",
      "KC_6",
      "KC_7",
      "KC_I",
      "KC_RBRC",
      "KC_K",
      "KC_F6",
      "KC_COMM",
      "KC_POWER",
      "KC_EQL",
      "KC_8",
      "KC_O",
      "KC_MPRV",
      "KC_L",
      "KC_DOWN",
      "KC_DOT",
      "KC_END",
      "KC_MPLY",
      "KC_9",
      "KC_P",
      "KC_LBRC",
      "KC_SCLN",
      "KC_QUOT",
      "KC_NO",
      "KC_SLSH",
      "KC_MINS",
      "KC_0",
      "KC_LALT",
      "KC_RSFT",
      "MO(1)",
      "KC_LGUI",
      "KC_SPC",
      "KC_RGUI",
      "KC_NO",
      "KC_DEL",
      "KC_NO",
      "KC_BSPC",
      "KC_BSLS",
      "KC_VOLD",
      "KC_ENT",
      "KC_VOLU",
      "KC_MNXT",
      "KC_MUTE"
    ],
    [
      "KC_TRNS",
      "KC_TRNS",
      "KC_NO",
      "RGB_SPD",
      "KC_TRNS",
      "RGB_SPI",
      "KC_TRNS",
      "KC_MPRV",
      "RGB_HUI",
      "KC_TRNS",
      "RGB_HUD",
      "KC_TRNS",
      "KC_TRNS",
      "KC_TRNS",
      "KC_TRNS",
      "RGB_TOG",
      "RGB_SAI",
      "KC_TRNS",
      "RGB_SAD",
      "KC_NO",
      "RGB_HUI",
      "KC_TRNS",
      "RGB_VAD",
      "KC_TRNS",
      "MACRO(0)",
      "KC_CALC",
      "KC_TRNS",
      "KC_MSEL",
      "KC_TRNS",
      "RGB_MOD",
      "RGB_VAI",
      "KC_TRNS",
      "KC_SLEP",
      "KC_TRNS",
      "KC_TRNS",
      "KC_TRNS",
      "KC_TRNS",
      "KC_TRNS",
      "KC_TRNS",
      "KC_TRNS",
      "KC_TRNS",
      "KC_TRNS",
      "KC_TRNS",
      "KC_TRNS",
      "KC_TRNS",
      "MAGIC_TOGGLE_NKRO",
      "KC_TRNS",
      "KC_TRNS",
      "MACRO(3)",
      "KC_TRNS",
      "KC_TRNS",
      "KC_MNXT",
      "KC_TRNS",
      "KC_TRNS",
      "KC_TRNS",
      "KC_TRNS",
      "KC_TRNS",
      "KC_MPLY",
      "KC_TRNS",
      "RGB_RMOD",
      "KC_TRNS",
      "KC_TRNS",
      "KC_MSTP",
      "KC_TRNS",
      "KC_TRNS",
      "KC_TRNS",
      "KC_TRNS",
      "KC_TRNS",
      "KC_NO",
      "KC_TRNS",
      "KC_TRNS",
      "KC_TRNS",
      "KC_TRNS",
      "KC_TRNS",
      "KC_TRNS",
      "KC_TRNS",
      "KC_TRNS",
      "KC_TRNS",
      "KC_NO",
      "KC_TRNS",
      "KC_NO",
      "KC_TRNS",
      "RESET",
      "KC_VOLU",
      "KC_TRNS",
      "KC_TRNS",
      "KC_MUTE",
      "KC_VOLD"
    ],
    [
      "KC_TRNS",
      "KC_TRNS",
      "KC_NO",
      "KC_TRNS",
      "KC_TRNS",
      "KC_TRNS",
      "KC_TRNS",
      "KC_TRNS",
      "KC_TRNS",
      "KC_TRNS",
      "KC_TRNS",
      "KC_TRNS",
      "KC_TRNS",
      "KC_TRNS",
      "KC_TRNS",
      "KC_TRNS",
      "KC_TRNS",
      "KC_TRNS",
      "KC_TRNS",
      "KC_NO",
      "KC_TRNS",
      "KC_TRNS",
      "KC_TRNS",
      "KC_TRNS",
      "KC_TRNS",
      "KC_TRNS",
      "KC_TRNS",
      "KC_TRNS",
      "KC_TRNS",
      "KC_TRNS",
      "KC_TRNS",
      "KC_TRNS",
      "KC_TRNS",
      "KC_TRNS",
      "KC_TRNS",
      "KC_TRNS",
      "KC_TRNS",
      "KC_TRNS",
      "KC_TRNS",
      "KC_TRNS",
      "KC_TRNS",
      "KC_TRNS",
      "KC_TRNS",
      "KC_TRNS",
      "KC_TRNS",
      "KC_TRNS",
      "KC_TRNS",
      "KC_TRNS",
      "KC_TRNS",
      "KC_TRNS",
      "KC_TRNS",
      "KC_TRNS",
      "KC_TRNS",
      "KC_TRNS",
      "KC_TRNS",
      "KC_TRNS",
      "KC_TRNS",
      "KC_TRNS",
      "KC_TRNS",
      "KC_TRNS",
      "KC_TRNS",
      "KC_TRNS",
      "KC_TRNS",
      "KC_TRNS",
      "KC_TRNS",
      "KC_TRNS",
      "KC_TRNS",
      "KC_TRNS",
      "KC_NO",
      "KC_TRNS",
      "KC_TRNS",
      "KC_TRNS",
      "KC_TRNS",
      "KC_TRNS",
      "KC_TRNS",
      "KC_TRNS",
      "KC_TRNS",
      "KC_TRNS",
      "KC_NO",
      "KC_TRNS",
      "KC_NO",
      "KC_TRNS",
      "KC_TRNS",
      "KC_TRNS",
      "KC_TRNS",
      "KC_TRNS",
      "KC_TRNS",
      "KC_TRNS"
    ],
    [
      "KC_TRNS",
      "KC_TRNS",
      "KC_NO",
      "KC_TRNS",
      "KC_TRNS",
      "KC_TRNS",
      "KC_TRNS",
      "KC_TRNS",
      "KC_TRNS",
      "KC_TRNS",
      "KC_TRNS",
      "KC_TRNS",
      "KC_TRNS",
      "KC_TRNS",
      "KC_TRNS",
      "KC_TRNS",
      "KC_TRNS",
      "KC_TRNS",
      "KC_TRNS",
      "KC_NO",
      "KC_TRNS",
      "KC_TRNS",
      "KC_TRNS",
      "KC_TRNS",
      "KC_TRNS",
      "KC_TRNS",
      "KC_TRNS",
      "KC_TRNS",
      "KC_TRNS",
      "KC_TRNS",
      "KC_TRNS",
      "KC_TRNS",
      "KC_TRNS",
      "KC_TRNS",
      "KC_TRNS",
      "KC_TRNS",
      "KC_TRNS",
      "KC_TRNS",
      "KC_TRNS",
      "KC_TRNS",
      "KC_TRNS",
      "KC_TRNS",
      "KC_TRNS",
      "KC_TRNS",
      "KC_TRNS",
      "KC_TRNS",
      "KC_TRNS",
      "KC_TRNS",
      "KC_TRNS",
      "KC_TRNS",
      "KC_TRNS",
      "KC_TRNS",
      "KC_TRNS",
      "KC_TRNS",
      "KC_TRNS",
      "KC_TRNS",
      "KC_TRNS",
      "KC_TRNS",
      "KC_TRNS",
      "KC_TRNS",
      "KC_TRNS",
      "KC_TRNS",
      "KC_TRNS",
      "KC_TRNS",
      "KC_TRNS",
      "KC_TRNS",
      "KC_TRNS",
      "KC_TRNS",
      "KC_NO",
      "KC_TRNS",
      "KC_TRNS",
      "KC_TRNS",
      "KC_TRNS",
      "KC_TRNS",
      "KC_TRNS",
      "KC_TRNS",
      "KC_TRNS",
      "KC_TRNS",
      "KC_NO",
      "KC_TRNS",
      "KC_NO",
      "KC_TRNS",
      "KC_TRNS",
      "KC_TRNS",
      "KC_TRNS",
      "KC_TRNS",
      "KC_TRNS",
      "KC_TRNS"
    ]
  ],
  "encoders": [
    [
      ["KC_VOLU", "KC_VOLD"],
      ["KC_TRNS", "KC_TRNS"],
      ["KC_TRNS", "KC_TRNS"],
      ["KC_TRNS", "KC_TRNS"]
    ]
  ]
}